pop	SupPop
GBR	EUR
FIN	EUR
IBS	EUR
CEU	EUR
TSI	EUR
YRI	AFR
LWK	AFR
ASW	AFR
ACB	AFR
ESN	AFR
GWD	AFR
MSL	AFR
CDX	EAS
KHV	EAS
CHB	EAS
PJL	SAS
BEB	SAS
GIH	SAS
ITU	SAS
STU	SAS
CHS	EAS
JPT	EAS
PUR	AMR
CLM	AMR
MXL	AMR
PEL	AMR
Bogazici	TGP
Turkey	TGP	